##########################################################################################################################################################################################################################################################################
####################################################################################################################################################********##############################################################################################################
################################################################################################################################################************##############################################################################################################
####################    ##################################################                      ****************######################    ************      ##############################################################################################################
####################        ####################################****                              ************************                                  ##############################################################################################################
####################            ####################**************                                    ******************                                            ######################################################################################################
######################              ############******************          ****                              ********                              **********        ####################################################################################################
######################              ****######    ********************    **********        ####################                                  ******##########        ################################################################################################
########################            ********        ********************  ##****########################################******                    ******############          ############################################################################################
##########################          ******            **********############****##########################################**********              ******##############        ############################################################################################
##############################    ******              ********##############******######################################************              ****##################      ############################################################################################
################################********              ******################******######################################**************            ****####################################################################################################################
##################################****                ########################  **######################################****************            **####################################################################################################################
##################################**                  ########################      ####################################******************            ####################################################################################################################
####################################                  ########################          ################################******************              ##################################################################################################################
##################################                      ########################          ############################******    ************              ################################################################################################################
################################                            ####################          ############################            ******####                ##############################################################################################################
################################          ####                ####################      ############################              ############              ##############################################################################################################
##############################          ############          **##################################################**          ##################            ##############################################################################################################
##############################          ##############      ******##############################################****          ##################            ##############################################################################################################
############################      ****##################************##########################################******        ######################            ############################################################################################################
##########################**********######################******      ######################################********      ##########################          ############################################################################################################
##########################**********########################**          ##################################**********    ############################          ############################################################################################################
##########################********############################          ****############################**********    ##############################          **##########################################################################################################
########################**********##############################        ******########################**********    ##################################        **##########################################################################################################
########################********##################################    ************####################********    ####################################        ****########################################################################################################
########################********####################################**********        ##############********    ########################################      ****##################################################**##********##########################################
######################    ****##########################################****            ##########******      ##########################################      ****############################################      **************########################################
######################    ****##############################################                                ############################################        ****########################################              ************####****############################
######################      **################################################                          ########################    ####################        ****####################################****                    ****************##########################
######################        ##################################################                        ######################        ##################        ****##############################********                        **************##########################
######################        ####################################################                  ##########################          ################        ****############################******                                **********##########################
######################        ####################################################        T          ##########################      ##################        ****########################******                                      ********###########################
######################        ####################################################                  **############################  ######################      ******  **************************                                        ******##########################
######################        ####################################################                  **############################  ######################      ******  ************************                                        ********##########################
######################**      ##################################################                  ********########################  **####################      ******  **************************                                      ********##########################
######################**      ################################################                ****************####################  **##################        ****################****************                                    ****##############################
######################****      ##########################################**              ##########************##################  **##################        ****##############################****                                  ****##############################
###############**********      ########################################****            ##############**************##############****##################        ****##############################****                                ****#################################
############                    ####################################********          ##################**************##########****##################          **##################################**                                ****################################
####            ########          ################################********            ####################**********    ######******##################        ****##################################****                            ****##################################
####      ##############          ##############################**********          ########################****                **##################          ****##################################******                        ******##################################
####      ################          ##########################**********          ##########################****                ####################          ****##########################################                  **********##################################
##########################            ####################**********          ################################                    ################          ****##################################################  ****************######################################
##########################            **############      ******          ######################################                    ##############          ****########################################################****##****########################################
############################        ******########                  ############################################                      ##########              ############################################################################################################
#############################  ************##****                ################################################                        ######            ###############################################################################################################
##############################********************              ##########################      ####################                                        ##############################################################################################################
################################****************              ##########################          ####################                                    ################################################################################################################
##################################************              ############################          ######################              ************      ##################################################################################################################
################################**********                ################################      ##########################          **************      ##################################################################################################################
##############################    **                      ################################**  ############################      ****************      ####################################################################################################################
##########################                                  ##############################****############################    ****************      ######################################################################################################################
######################                                              ######################****########################        ****************      ######################################################################################################################
######################                                                    ################****####################          ****************        ######################################################################################################################
######################                                    **********              ########****############                **********                  ####################################################################################################################
######################                              ******************                  ******##                          ****                          ##################################################################################################################
####################                              ######******************                                                                              ##################################################################################################################
####################                          ##################************                                              ########                      ##################################################################################################################
####################                  ##############################************                                      ################                  ##################################################################################################################
####################            ############################################******                          ################################              ################################################################################################################
##################    ################################################################################################################################    ################################################################################################################
##########################################################################################################################################################################################################################################################################