############################################################################################################################################################################################################################################
##################################################################################################################################################********##################################################################################
##############################################################################################################################################************##################################################################################
##################    ##################################################                      ****************######################    ************      ##################################################################################
##################        ####################################****                               ************************                                  ##################################################################################
##################            ####################**************                                    ******************                                            ##########################################################################
####################              ############******************          ****                              ********                              **********        ########################################################################
####################              ****######    ********************    **********        ####################                                  ******##########        ####################################################################
######################            ********        ********************  ##****########################################******                    ******############          ################################################################
########################          ******            **********############****##########################################**********              ******##############        ################################################################
############################    ******              ********##############******######################################************              ****##################      ################################################################
##############################********              ******################******######################################**************            ****########################################################################################
################################****                ########################  **######################################****************            **########################################################################################
################################**                  ########################      ####################################******************            ########################################################################################
##################################                  ########################          ################################******************              ######################################################################################
################################                      ########################          ############################******    ************              ####################################################################################
##############################                            ####################          ############################            ******####                ##################################################################################
##############################          ####                ####################      ############################              ############              ##################################################################################
############################          ############          **##################################################**          ##################            ##################################################################################
############################          ##############      ******##############################################****          ##################            ##################################################################################
##########################      ****##################************##########################################******        ######################            ################################################################################
########################**********######################******      ######################################********      ##########################          ################################################################################
########################**********########################**          ##################################**********    ############################          ################################################################################
########################********############################          ****############################**********    ##############################          *###############################################################################
######################**********##############################        ******########################**********    ##################################        **##############################################################################
######################********##################################    ************####################********    ####################################        ****############################################################################
######################********####################################**********        ##############********    ########################################      ****###############################################**##********#################
####################    ****##########################################****            ##########******      ##########################################      ****#########################################      **************###############
####################    ****##############################################                                ############################################        ****#####################################              ************####****###
####################      **################################################                          ########################    ####################        ****#################################****                    ****************#
####################        ##################################################                        ######################        ##################        ****###########################********                        **************#
####################        ####################################################                  ##########################          ################        ****#########################******                                **********#
####################        ####################################################        T          ##########################      ##################        ****#####################******                                      ********##
####################        ####################################################                  **############################  ######################      ******  ***********************                                        ******#
####################        ####################################################                  **############################  ######################      ******  *********************                                        ********#
####################**      ##################################################                  ********########################  **####################      ******  ***********************                   A                  ********#
####################**      ################################################                ****************####################  **##################        ****#############****************                                    ****#####
####################****      ##########################################**              ##########************##################  **##################        ****###########################****                                  ****#####
#############**********      ########################################****            ##############**************##############****##################        ****###########################****                                ****########
##########                    ####################################********          ##################**************##########****##################          **###############################**                                ****#######
##            ########          ################################********            ####################**********    ######******##################        ****###############################****                            ****#########
##      ##############          ##############################**********          ########################****                **##################          ****###############################******                        ******#########
##      ################          ##########################**********          ##########################****                ####################          ****#######################################                  **********#########
########################            ####################**********          ################################                    ################          ****###############################################  ****************#############
########################            **############      ******          ######################################                    ##############          ****#####################################################****##****###############
##########################        ******########                  ############################################                      ##########              ################################################################################
###########################  ************##****                ################################################                        ######            ###################################################################################
############################********************              ##########################      ####################                                        ##################################################################################
##############################****************              ##########################          ####################                                    ####################################################################################
################################************              ############################          ######################              ************      ######################################################################################
##############################**********                ################################      ##########################          **************      ######################################################################################
############################    **                      ################################**  ############################      ****************      ########################################################################################
########################                                  ##############################****############################    ****************      ##########################################################################################
####################                                              ######################****########################        ****************      ##########################################################################################
####################                                                    ################****####################          ****************        ##########################################################################################
####################                                    **********              ########****############                **********                  ########################################################################################
####################                              ******************                  ******##                          ****                          ######################################################################################
##################                              ######******************                                                                              ######################################################################################
##################                          ##################************                                              ########                      ######################################################################################
##################                  ##############################************                                      ################                  ######################################################################################
##################            ############################################******                          ################################              ####################################################################################
################    ################################################################################################################################    ####################################################################################
############################################################################################################################################################################################################################################