#################################################################################################
#################################################################################################
##########################*****#####################################    #################******##
###################*************###################################     #######    ######*    *##
########*******   **       ******################################                  ######      ##
########*****                 ****############################                     ######      ##
########**                      ****######################                           ####      ##
###### ***                        *********                                          ####      ##
######   ** #####                                      ###                           ####      ##
######    #######         *                         ########                                   ##
#### *** #####*          ***                       #########                              #######
###    **###*****         *       #######          ######       #####################     #######
###     ###*******               ##########                     #####################     #######
###     # *****##########       #############                   #####################       #####
##**           ##########       ##############   **   ###################################   #####
##***          ##########          ##########  ****** ###################################   #####
## ****        ##########             #####  *********###################################      ##
##  *******    ##########                  ****** ###################################          ##
###    *****  ###########     ************        ################################### ****     ##
####      ***############      ************   ####################################### ******   ##
####        *###############     *******      ###################################     *******  ##
####*       *###############                  ###################################   *********  ##
####**  @  **#####################                 #############                    ********   ##
####***   ***#########################                               #############      ****   ##
######*****###############################                           ######################    ##
#################################################      ####################################    ##
#################################################################################################
#################################################################################################