############################################################################################################################################################################################################################################
#######*####################################################################################################################################################################################################################################
##########################*****#####################################    #################******#############################################################################################################################################
###################*************###################################     #######    ######*    *#############################################################################################################################################
########*******   **       ******################################                  ######      #############################################################################################################################################
########*****                 ****############################                     ######      #############################################################################################################################################
########**    @                  ****######################                           ####      #############################################################################################################################################
###### ***                        *********                                          ####      #############################################################################################################################################
######   ** #####                                      ###                           ####      #############################################################################################################################################
######    #######         *                         ########                                   #############################################################################################################################################
#### *** #####*          ***                       #########                              ##################################################################################################################################################
###    **###*****         *       #######          ######       #####################     ##################################################################################################################################################
###     ###*******               ##########                     #####################     ##################################################################################################################################################
###     # *****##########       #############                   #####################       ################################################################################################################################################
##**           ##########       ##############   **   ###################################   ################################################################################################################################################
## ****        ##########             #####  *********###################################      #############################################################################################################################################
##  *******    ##########                  ****** ###################################          #############################################################################################################################################
###    *****  ###########     ************        ################################### ****     #############################################################################################################################################
####      ***############      ************   ####################################### ******   #############################################################################################################################################
####        *###############     *******      ###################################     *******  #############################################################################################################################################
####*       *###############                  ###################################   *********  #############################################################################################################################################
####**     **#####################                 #############                    ********   #############################################################################################################################################
####***   ***#########################                               #############      ****   #############################################################################################################################################
######*****###############################                           ######################    #############################################################################################################################################
#################################################      ####################################    #############################################################################################################################################
############################################################################################################################################################################################################################################
############################################################################################################################################################################################################################################
############################################################################################################################################################################################################################################
##########################*****#####################################    #################******#############################################################################################################################################
###################*************###################################     #######    ######*    *#############################################################################################################################################
########*******   **       ******################################                  ######      #############################################################################################################################################
########*****                 ****############################                     ######      #############################################################################################################################################
########**                      ****######################                           ####      #############################################################################################################################################
###### ***                        *********                                          ####      #############################################################################################################################################
######   ** #####                                      ###                           ####      #############################################################################################################################################
######    #######         *                         ########                                   #############################################################################################################################################
#### *** #####*          ***                       #########                              ##################################################################################################################################################
###    **###*****         *       #######          ######       #####################     ##################################################################################################################################################
###     ###*******               ##########                     #####################     ##################################################################################################################################################
###     # *****##########       #############                   #####################       ################################################################################################################################################
##**           ##########       ##############   **   ###################################   ################################################################################################################################################
## ****        ##########             #####  *********###################################      #############################################################################################################################################
##  *******    ##########                  ****** ###################################          #############################################################################################################################################
###    *****  ###########     ************        ################################### ****     #############################################################################################################################################
####      ***############      ************   ####################################### ******   #############################################################################################################################################
####        *###############     *******      ###################################     *******  #############################################################################################################################################
####*       *###############                  ###################################   *********  #############################################################################################################################################
####**     **#####################                 #############                    ********   #############################################################################################################################################
####***   ***#########################                               #############      ****   #############################################################################################################################################
######*****###############################                           ######################    #############################################################################################################################################
#################################################      ####################################    #############################################################################################################################################
############################################################################################################################################################################################################################################
##  *******    ##########                  ****** ###################################          #############################################################################################################################################
###    *****  ###########     ************        ################################### ****     #############################################################################################################################################
####      ***############      ************   ####################################### ******   #############################################################################################################################################
####        *###############     *******      ###################################     *******  #############################################################################################################################################
####*       *###############                  ###################################   *********  #############################################################################################################################################
####**     **#####################                 #############                    ********   #############################################################################################################################################
####***   ***#########################                               #############      ****   #############################################################################################################################################
######*****###############################                           ######################    #############################################################################################################################################
#################################################      ####################################    #############################################################################################################################################
############################################################################################################################################################################################################################################
############################################################################################################################################################################################################################################